++++++++++
+........+
+...^....+
+.+......+
++++.+++++
+.....+
+++++++