++++++++++
+........+
+........+
+........+
+.+......+
++++.+++++
+....<+
+++++++