++++++++++
+.......<+
+........+
+........+
+.+......+
++++.+++++
+.....+
+++++++