++++++++++
+........+
+........+
+........+
+.+......+
++++.+++++
+....^+
+++++++