++++++++++
+........+
+........+
+........+
+.+......+
++++.+++++
+....v+
+++++++