++++++++++
+........+
+........+
+........+
+.+......+
++++.+++++
+....>+
+++++++