++++++++++
+........+
+...+..+.+
+........+
+.+.^....+
+.....++++
+.....+
+++++++