++++++++++
+........+
+...v....+
+........+
+.+......+
++++.+++++
+.....+
+++++++