++++++++++
+........+
+.......^+
+........+
+.+......+
++++.+++++
+.....+
+++++++